15
220111121111022
221111111111122
011011110101111
111101111111101
011111111011022
111022111111122
111122111111111
110111111111110
111111122111111
011111022111011
111111111110111
111111111111011
111111011111100
220111111111122
221011121111022
