15
111111111111111
100000010000001
102211111112201
102211111112201
101111111111101
101111111111101
101111111111101
101111111111101
101111111111101
101111111111101
101111111111101
102211111112201
102211111112201
100000000000001
111111111111111
